
一、 资产合计 : bs.ta
净营运资本 : bs.nwc
流动资产合计 : bs.tca
流动资产占比 : bs.tca_ta_r
货币资金 : bs.cabb
货币资金占比 : bs.cabb_ta_r
结算备付金 : bs.sr
拆出资金 : bs.pwbaofi
交易性金融资产 : bs.tfa
衍生金融资产(流动) : bs.cdfa
应收票据及应收账款 : bs.nraar
(其中) 应收票据 : bs.nr
(其中) 应收账款 : bs.ar
应收款项融资 : bs.rf
预付款项 : bs.ats
应收保费 : bs.pr
应收分保账款 : bs.rir
应收分保合同准备金 : bs.crorir
其他应收款 : bs.or
(其中) 应收利息 : bs.ir
(其中) 应收股利 : bs.dr
买入返售金融资产 : bs.fahursa
存货 : bs.i
合同资产 : bs.ca
持有待售资产 : bs.ahfs
发放贷款及垫款(流动) : bs.claatc
待摊费用 : bs.pe
一年内到期的非流动资产 : bs.ncadwioy
其他流动资产 : bs.oca
流动比率 : bs.tca_tcl_r
速动比率 : bs.q_r
非流动资产合计 : bs.tnca
非流动资产占比 : bs.tnca_ta_r
重资产占比 : bs.ah_ta_r
发放贷款及垫款(非流动) : bs.nclaatc
债权投资 : bs.cri
其他债权投资 : bs.ocri
可供出售金融资产(非流动) : bs.ncafsfa
持有至到期投资 : bs.htmi
长期应收款 : bs.ltar
长期股权投资 : bs.ltei
其他权益工具投资 : bs.oeii
其他非流动金融资产 : bs.oncfa
投资性房地产 : bs.rei
固定资产 : bs.fa
(其中) 固定资产清理 : bs.dofa
固定资产占总资产比率 : bs.fa_ta_r
在建工程 : bs.cip
(其中) 工程物资 : bs.es
在建工程占固定资产比率 : bs.cip_fa_r
生产性生物资产 : bs.pba
油气资产 : bs.oaga
公益性生物资产 : bs.pwba
使用权资产 : bs.roua
无形资产 : bs.ia
开发支出 : bs.rade
商誉 : bs.gw
商誉占净资产比率 : bs.gw_toe_r
长期待摊费用 : bs.ltpe
递延所得税资产 : bs.dita
其他非流动资产 : bs.onca
二、 负债合计 : bs.tl
有息负债 : bs.lwi
有息负债率 : bs.lwi_ta_r
资产负债率 : bs.tl_ta_r
流动负债合计 : bs.tcl
流动负债占比 : bs.tcl_tl_r
短期借款 : bs.stl
向中央银行借款 : bs.bfcb
拆入资金 : bs.pfbaofi
衍生金融负债 : bs.dfl
交易性金融负债 : bs.tfl
应付票据及应付账款 : bs.npaap
(其中) 应付票据 : bs.np
(其中) 应付账款 : bs.ap
预收账款 : bs.afc
合同负债 : bs.cl
卖出回购金融资产 : bs.fasurpa
吸收存款及同业存放 : bs.dfcab
代理买卖证券款 : bs.stoa
代理承销证券款 : bs.ssoa
应付职工薪酬 : bs.sawp
应交税费 : bs.tp
其他应付款 : bs.oap
(其中) 应付利息 : bs.intp
(其中) 应付股利 : bs.dp
应付手续费及佣金 : bs.facp
应付分保账款 : bs.rip
持有待售负债 : bs.lhfs
一年内到期的非流动负债 : bs.ncldwioy
一年内到期的递延收益 : bs.didwioy
预计负债(流动) : bs.cal
短期应付债券 : bs.stbp
其他流动负债 : bs.ocl
非流动负债合计 : bs.tncl
非流动负债占比 : bs.tncl_tl_r
保险合同准备金 : bs.icr
长期借款 : bs.ltl
应付债券 : bs.bp
(其中) 优先股 : bs.psibp
(其中) 永续债 : bs.pcsibp
租赁负债 : bs.ll
长期应付款 : bs.ltap
(其中) 专项应付款 : bs.sap
长期应付职工薪酬 : bs.ltpoe
预计负债(非流动) : bs.ncal
长期递延收益 : bs.ltdi
递延所得税负债 : bs.ditl
其他非流动负债 : bs.oncl
三、 所有者权益合计 : bs.toe
股东权益占比 : bs.toe_ta_r
股本 : bs.sc
其他权益工具 : bs.oei
(其中) 优先股 : bs.psioei
(其中) 永续债 : bs.pcsioei
资本公积 : bs.capr
减： 库存股 : bs.is
其他综合收益 : bs.oci
专项储备 : bs.rr
盈余公积 : bs.surr
一般风险准备金 : bs.pogr
未分配利润 : bs.rtp
归属于母公司股东及其他权益持有者的权益合计 : bs.tetshaoehopc
归属于母公司普通股股东权益合计 : bs.tetoshopc
归属于母公司普通股股东的每股股东权益 : bs.tetoshopc_ps
少数股东权益 : bs.etmsh
四、 员工情况
员工人数 : bs.ep_stn
博士人数 : bs.ep_pn
硕士人数 : bs.ep_mn
学士人数 : bs.ep_bn
大专人数 : bs.ep_jcn
高中及以下人数 : bs.ep_hsabn
生产人员人数 : bs.ep_psn
销售人员人数 : bs.ep_spn
技术人员人数 : bs.ep_tsn
财务人员人数 : bs.ep_fon
行政人员人数 : bs.ep_asn
其他人员人数 : bs.ep_osn
五、 股本、股东和估值
市值 : bs.mc
总股本 : bs.tsc
流通股本 : bs.csc
股东人数(季度) : bs.shn
第一大股东持仓占总股本比例 : bs.shbt1sh_tsc_r
前十大股东持仓占总股本比例 : bs.shbt10sh_tsc_r
前十大流通股东持仓占流通股本比例 : bs.shbt10sh_csc_r
公募基金持仓占流通股本比例 : bs.shbpoof_csc_r
公募基金+自由流通股东持仓占自由流通股本比例 : bs.shbeosh_poof_ecsc_r
PE-TTM : bs.pe_ttm
PE-TTM(扣非) : bs.d_pe_ttm
PB : bs.pb
PB(不含商誉) : bs.pb_wo_gw
PS-TTM : bs.ps_ttm
股息率 : bs.dyr
分红率 : bs.d_np_r