
一、 经营活动产生的现金流量
销售商品、提供劳务收到的现金 : cfs.crfscapls
发放贷款及垫款的净减少额 : cfs.ndilaatc
客户存款和同业及其他金融机构存放款项净增加额 : cfs.niicdadfbaofi
向中央银行借款净增加额 : cfs.niibfcb
向其他金融机构拆入资金净增加额 : cfs.niipfofi
收到原保险合同保费取得的现金 : cfs.crfp
收到再保险业务现金净额 : cfs.ncrfrib
保户储金及投资款净增加额 : cfs.niiphd
为交易目的而持有的金融资产净减少额 : cfs.ndifahftp
拆入资金净增加额 : cfs.niipfbaofi
卖出回购业务资金净增加额 : cfs.niifasurpaioa
收取利息、手续费及佣金的现金 : cfs.crfifac
代理买卖证券收到的现金净额 : cfs.ncrfstoa
收到的税费返还 : cfs.crfwbot
收到的其他与经营活动有关现金 : cfs.crrtooa
经营活动现金流入小计 : cfs.stciffoa
购买商品、接收劳务支付的现金 : cfs.cpfpcarls
发放贷款及垫款的净增加额 : cfs.niilaatc
存放中央银行和同业及其他金融机构款项净增加额 : cfs.niibwcbbaofi
向其他金融机构拆入资金净减少额 : cfs.ndipfofi
支付原保险合同赔付等款项的现金 : cfs.cpfc
拆出资金增加额 : cfs.niipwbaofi
买入返售金融资产净增加额 : cfs.niifahursaioa
支付保单红利的现金 : cfs.cpfphd
为交易目的而持有的金融资产净增加额 : cfs.niifahftp
支付利息、手续费及佣金的现金 : cfs.cpfifac
支付给职工及为职工支付的现金 : cfs.cptofe
支付的各种税费 : cfs.cpft
支付的其他与经营活动有关现金 : cfs.cprtooa
经营活动现金流出小计 : cfs.stcoffoa
经营活动产生的现金流量净额 : cfs.ncffoa
二、 投资活动产生的现金流量金额
收回投资收到的现金 : cfs.crfrci
取得投资收益所收到的现金 : cfs.crfii
处置固定资产、无形资产及其他长期资产收到的现金 : cfs.crfdofiaolta
处置子公司、合营联营企业及其他营业单位收到的现金净额 : cfs.ncrfdossajvaou
(其中) 处置子公司或其他营业单位收到的现金净额 : cfs.ncrfdossaou
(其中) 处置合营或联营公司所收到的现金 : cfs.ncrfdoaajv
收到的其他与投资活动相关的现金 : cfs.crrtoia
投资活动现金流入小计 : cfs.stcifia
购建固定资产、无形资产及其他长期资产所支付的现金 : cfs.cpfpfiaolta
投资所支付的现金 : cfs.cpfi
质押贷款净增加额 : cfs.niipl
取得子公司、合营联营企业及其他营业单位支付的现金净额 : cfs.ncpfbssajvaou
(其中) 取得子公司及其营业单位支付的现金净额 : cfs.ncpfbssaou
(其中) 取得联营及合营公司支付的现金净额 : cfs.ncpfbajv
支付的其他与投资活动有关的现金 : cfs.cprtoia
投资活动现金流出小计 : cfs.stcoffia
投资活动产生的现金流量净额 : cfs.ncffia
三、 筹资活动产生的现金流量
吸收投资收到的现金 : cfs.crfai
(其中) 子公司吸收少数股东投资收到的现金 : cfs.crfamshibss
取得借款收到的现金 : cfs.crfl
发行债券收到的现金 : cfs.crfib
收到的其他与筹资活动有关的现金 : cfs.crrtofa
筹资活动产生的现金流入小计 : cfs.stcifffa
偿付债务支付的现金 : cfs.cpfbrp
分配股利、利润或偿付利息所支付的现金 : cfs.cpfdapdoi
(其中) 子公司支付少数股东股利及利润 : cfs.cpfdapomshpbss
支付的其他与筹资活动有关的现金 : cfs.cprtofa
筹资活动产生的现金流出小计 : cfs.stcofffa
筹资活动产生的现金流量净额 : cfs.ncfffa
四、 汇率变动对现金及现金等价物的影响 : cfs.iocacedtfier
期初现金及现金等价物的余额 : cfs.bocaceatpb
现金及现金等价物的净增加额 : cfs.niicace
期末现金及现金等价物净余额 : cfs.bocaceatpe
五、 附注
净利润 : cfs.np
加： 资产减值准备 : cfs.ioa
信用减值损失 : cfs.cilor
固定资产折旧、油气资产折耗、生产性生物资产折旧 : cfs.dofx_dooaga_dopba
投资性房地产的折旧及摊销 : cfs.daaorei
无形资产摊销 : cfs.aoia
长期待摊费用摊销 : cfs.aoltde
处置固定资产、无形资产和其他长期资产的损失 : cfs.lodofaiaaolta
固定资产报废损失 : cfs.lfsfa
公允价值变动损失 : cfs.lfcifv
财务费用 : cfs.fe
投资损失 : cfs.il
递延所得税资产减少 : cfs.didita
递延所得税负债增加 : cfs.iiditl
存货的减少 : cfs.dii
经营性应收项目的减少 : cfs.dior
经营性应付项目的增加 : cfs.iiop
其他 : cfs.o
债务转为资本 : cfs.coditc
一年内到期的可转换公司债券 : cfs.cbdwioy
融资租入固定资产 : cfs.flofa